33220311111030120231012
23310321102223112222030
32103200213131333032210
22000023233022211113310
31121113122101200210002
23111332322021223023032
32220021320323202022210
13311030103020013120130
11211211200011213333222
13111032012120203313312
30312011212013000133022
10203023233023111200320
22223112033110220321222
23123213323211300020322
01203012232201131122230
20311102102031333233202
12132332103112302113012
31000002331313223021020
22112022022213200203002
30101031023231212111112
23110100121030130303332
12120021031131312101002
11112122113222121300020
23012231332300331330002
30020130332330020113212
33330022102102020022000
01022012213201102111320
00301013333110322013020
01321203003003133213100
11220132300022301330202
21211312100330011120312
01010110100110111001100
