211212213333020110
233030102203130022
213213232032200020
130113211210311212
210300322321333220
201102212311223120
121030003122330022
323011332321231032
200002323222033200
230330023003202000
202133222232312100
020201110232213130
231023202221311202
310031112102330212
021002131310022210
303331213221201100
023303103122031210
222103010101222312
013323332000120032
323003223221030230
331102300020331110
223032311031131210
122111312230233310
310211030230321232
230110203103122200
033101010112220310
232212211133221330
312103321213333002
022110101201203020
020323012011212322
310212230113132030
220211331332211312
000011233030321130
313023231012202210
212130013203320322
001111000010111110
