213223101010030101220322
133130311032132133112312
321322300230213200312320
320101300102300123320030
002313022201003201300220
112032222300133302233010
103021112113330330333012
110032000302221103032232
313012031103302233200030
003021213131133312132200
030202200101101022200022
202312131130320221211220
012110120011100302210220
221222222222301330330230
030033131001101033131330
203023231323002220132330
312031001000330203132120
023001101220210110200232
313032030013222321312032
101210330301111033032202
232312323001022332230322
301203322123312033110320
032032011330231312132232
302000020110001113231230
030103210033022230202302
333131132130121023120210
023223100111311000310312
230131303022032022000322
123122321320332131010302
133010133002323332020020
333001231113231122002320
001101001010000110010000
