220221201233130323213012
010022001333213101102320
012212212331111101222100
233121101131213333202200
001212220322231002002232
222303201231120333302120
112333200002320313332132
321321012031331002200020
021011011333133232203330
000310211003233030302100
322320021211230002002100
102033203122233300232210
000210321001021310120232
200321200231103132310322
210203301012221000021330
022233121001331001110130
332101330121032311312132
102223310321311000000112
331310111320331212131112
030021133102303210002320
023313110303231213323230
312031133112320123311030
110312133203232300001120
332220230101032321310012
302303301232012120203332
213013323313112210321120
001021232032213123301302
003031303203211031222310
122212130103022132133122
020031311000330300203002
301300232222120310320112
001123001301302310202100
201011222311013111102300
000100101100011100110100
