3003200320202330
1033312211100210
0102003100022320
2330222322320302
1201323232021202
1132230201030012
3301132322130202
2301111232330232
2312022301113332
2032223123120100
0130233312122100
2123301023012210
2132112033121220
1101011111001110
