313301212122020022123311330
310132311001100010323322032
220010002011332231222131022
103110132313011320132312122
213311031110023000133121210
200130131310222122302102120
210011132231311130313012302
032231311221311000021012322
332301221311021220233302302
213030102110132230020221200
300120223000112311320120010
311000312002202013230100232
301021121021201001123100130
230133221020313130123201022
100012012302000012003323030
111131103100211123003203120
013133332100233033002032312
113223013022202132313120232
221333222011300221213313022
010001100100101001111111110
