321133132322021113220220
013333110103103222220010
321211320222100123000310
200013302220123030112232
113013332312333120302320
001021312200023233301010
033122121010302200303120
020002232000113030201312
331221331231102002211202
023113320330322220311030
113200210011321310210030
011101010100010111001110
