12322123020103212
31212103332102130
33110021221132322
23021303300132322
03111000212321130
10011030023022230
01000011101110100
